30 29 16 16 
1 6 1 6 1 6 1 6 1 6 1 6 1 6 1 6 1 6 1 6 1 6 1 6 1 6 1 6 1 6 1 6 1 6 1 6 1 6 1 6 1 6 1 6 1 6 1 6 1 6 1 6 1 6 1 6 1 6 1 6 
1 6 1 6 1 6 1 6 1 6 1 6 0 5 0 5 0 5 0 5 0 5 1 5 1 6 0 5 0 5 0 5 0 5 1 5 1 6 0 5 1 5 1 6 1 6 1 6 1 6 1 6 1 6 1 6 1 5 1 6 
1 6 0 5 0 5 0 5 0 5 0 5 0 5 0 5 0 5 1 5 1 5 0 5 0 5 0 5 1 5 1 5 0 5 1 5 1 6 0 5 0 5 0 5 0 5 0 5 0 5 0 5 0 5 0 5 1 5 1 6 
1 6 1 5 1 5 1 5 0 5 1 5 1 5 1 5 0 5 1 5 1 6 0 5 1 5 1 5 1 5 1 6 0 5 1 5 1 6 0 5 1 5 1 5 1 5 0 5 1 5 1 5 1 5 0 5 1 5 1 6 
1 6 1 6 1 6 1 6 0 5 1 5 1 6 1 6 0 5 1 5 1 6 0 5 1 5 1 6 1 6 1 6 0 5 1 5 1 6 0 5 1 5 1 6 1 6 0 5 1 5 1 6 1 6 0 5 1 5 1 6 
1 6 0 5 0 5 0 5 0 5 1 5 1 6 0 5 0 5 0 5 0 5 0 5 0 5 0 5 1 5 1 6 0 5 0 5 0 5 0 5 1 5 1 6 0 5 0 5 0 5 0 5 0 5 0 5 1 5 1 6 
1 6 0 5 1 5 1 5 0 5 1 5 1 6 0 5 1 5 1 5 1 5 1 5 1 5 0 5 1 5 1 6 0 5 1 5 1 5 1 5 1 5 1 6 0 5 1 5 1 5 0 5 1 5 1 5 1 5 1 6 
1 6 0 5 1 5 1 6 0 5 1 5 1 6 0 5 1 5 1 6 1 6 1 6 1 6 0 5 1 5 1 6 0 5 1 5 1 6 1 6 1 6 1 6 0 5 1 5 1 6 0 5 1 5 1 6 1 6 1 6 
1 6 0 5 1 5 1 6 0 5 0 5 0 5 0 5 0 5 0 5 1 5 1 6 1 6 0 5 0 5 0 5 0 5 0 5 0 5 0 5 0 5 0 5 0 5 0 5 0 5 0 5 0 5 0 5 1 5 1 6 
1 6 0 5 1 5 1 6 0 5 1 5 1 5 1 5 1 5 0 5 1 5 1 6 1 6 0 5 0 5 1 5 1 5 0 5 1 5 1 5 1 5 0 5 1 5 1 5 1 5 1 5 1 5 0 5 1 5 1 6 
1 6 0 5 0 5 0 5 0 5 1 5 1 6 1 6 1 6 0 5 0 5 0 5 0 5 0 5 0 5 1 5 1 6 0 5 1 5 1 6 1 6 0 5 1 5 1 6 1 6 1 6 1 6 0 5 1 5 1 6 
1 6 0 5 1 5 1 5 1 5 1 5 1 6 0 5 0 5 0 5 1 5 1 5 0 5 1 5 1 5 1 5 1 6 0 5 1 5 1 6 0 5 0 5 1 5 1 6 0 5 0 5 0 5 0 5 1 5 1 6 
1 6 0 5 1 5 1 6 1 6 1 6 1 6 0 5 0 5 0 5 1 5 1 6 0 5 1 5 1 6 1 6 1 6 0 5 1 5 1 6 0 5 0 5 1 5 1 6 0 5 1 5 1 5 0 5 1 5 1 6 
1 6 0 5 0 5 0 5 0 5 0 5 0 5 0 5 0 5 0 5 0 5 0 5 0 5 0 5 0 5 0 5 0 5 0 5 0 5 0 5 0 5 0 5 1 5 1 6 0 5 1 5 1 6 0 5 1 5 1 6 
1 6 1 5 1 5 1 5 0 5 1 5 1 5 1 5 1 5 1 5 1 5 0 5 1 5 1 5 0 5 1 5 1 5 1 5 1 5 1 5 0 5 1 5 1 5 1 6 0 5 1 5 1 6 0 5 1 5 1 6 
1 6 1 6 1 6 1 6 0 5 1 5 1 6 1 6 1 6 1 6 1 6 0 5 1 5 1 6 1 5 1 5 1 6 1 6 1 6 1 6 0 5 1 5 1 6 1 6 0 5 0 5 0 5 0 5 1 5 1 6 
1 6 0 5 0 5 0 5 0 5 1 5 1 6 0 5 0 5 0 5 0 5 0 5 1 5 1 6 2 7 2 7 1 6 0 5 0 5 0 5 0 5 0 5 0 5 0 5 0 5 1 5 1 5 0 5 1 5 1 6 
1 6 0 5 1 5 1 5 0 5 1 5 1 6 0 5 1 5 1 5 0 5 1 5 1 5 1 6 2 7 2 7 1 6 0 5 1 5 1 5 0 5 1 5 1 5 1 5 0 5 1 5 1 6 0 5 1 5 1 6 
1 6 0 5 1 5 1 6 0 5 0 5 0 5 0 5 1 5 1 6 0 5 1 5 1 6 1 6 1 6 1 6 1 6 0 5 1 5 1 6 0 5 1 5 1 6 1 6 0 5 1 5 1 6 0 5 1 5 1 6 
1 6 0 5 1 5 1 6 0 5 1 5 1 5 1 5 1 5 1 6 0 5 0 5 0 5 0 5 0 5 0 5 0 5 0 5 0 5 0 5 0 5 0 5 0 5 0 5 0 5 0 5 0 5 0 5 1 5 1 6 
1 6 0 5 1 5 1 6 0 5 1 5 1 6 1 6 1 6 1 6 0 5 1 5 1 5 1 5 1 5 0 5 1 5 1 5 1 5 1 5 0 5 1 5 1 5 1 5 0 5 1 5 1 5 0 5 1 5 1 6 
1 6 0 5 0 5 0 5 0 5 0 5 0 5 0 5 1 5 1 6 0 5 1 5 1 6 1 6 1 6 0 5 1 5 1 6 1 6 1 6 0 5 1 5 1 6 1 6 0 5 1 5 1 6 0 5 1 5 1 6 
1 6 0 5 1 5 1 5 0 5 1 5 1 5 0 5 0 5 0 5 0 5 0 5 0 5 1 5 1 6 0 5 0 5 0 5 0 5 0 5 0 5 0 5 1 5 1 6 0 5 1 5 1 6 0 5 1 5 1 6 
1 6 0 5 1 5 1 6 0 5 1 5 1 6 0 5 1 5 1 5 1 5 1 5 0 5 1 5 1 6 0 5 1 5 1 5 0 5 1 5 1 5 0 5 1 5 1 6 0 5 1 5 1 6 0 5 1 5 1 6 
1 6 0 5 1 5 1 6 0 5 1 5 1 6 0 5 1 5 1 6 1 6 1 6 0 5 1 5 1 6 0 5 1 5 1 6 0 5 1 5 1 6 0 5 1 5 1 6 0 5 1 5 1 6 0 5 1 5 1 6 
1 6 0 5 0 5 0 5 0 5 1 5 1 6 0 5 0 5 0 5 0 5 0 5 0 5 0 5 0 5 0 5 0 5 0 5 0 5 1 5 1 6 0 5 0 5 0 5 0 5 0 5 0 5 0 5 1 5 1 6 
1 6 0 5 1 5 1 5 1 5 1 5 1 6 0 5 1 5 1 5 1 5 1 5 1 5 0 5 0 5 0 5 1 5 1 5 1 5 1 5 1 6 1 5 1 5 0 5 0 5 1 5 1 5 1 5 1 5 1 6 
1 6 1 5 1 5 1 6 1 6 1 6 1 6 1 5 1 5 1 6 1 6 1 6 1 6 1 5 1 5 1 5 1 5 1 6 1 6 1 6 1 6 1 6 1 6 1 5 1 5 1 5 1 6 1 6 1 6 1 6 
1 6 1 6 1 6 1 6 1 6 1 6 1 6 1 6 1 6 1 6 1 6 1 6 1 6 1 6 1 6 1 6 1 6 1 6 1 6 1 6 1 6 1 6 1 6 1 6 1 6 1 6 1 6 1 6 1 6 1 6 
